################################################################################################################################
#..............................................................................................................................#
#...........###................................................................................................................#
#...............#.........................................................##...................................................#
#...........#............................................................#.....................................................#
#.................#..........#.................................................................................................#
#...........#.....#....#.#.#.#.#....#..................................#.......................................................#
#....................#...................#.....#.#..##.#...............#.......................................................#
#................#...#.......................#.#...............................................................................#
#.............#........#.......................#.......................#...#...................................................#
#................#........#........................#....#....#..##.......#....#................................................#
#.................#........................................................#.###...............................................#
#...........................#..................................................................................................#
#.....................#..#..#..................................................................................................#
#..............................................................................................................................#
################################################################################################################################
