################################################################################################################################
#...............................................................................................................................
#...............................................................................................................................
#....................................................................................####.....................................##
#.............................................................................########...##.................................####
#...........................................................................###...........###..............................#####
#.........................................................................##................##...........................#######
#.......................................................................##....................#.........................########
#......................................................................#.......................###......................######.#
#.....................................................................##..........................##....................#####..#
#...................................................................###............................##...................###....#
#.......................................................#############................................##........############....#
#...................................................####.........###...................................#....####................
#..................################################.....................................................#####...................
#...####.####.##.############################################.........####......................................................
################################################################################################################################
