################################################################################################################################
#..............................................................................................................................#
#..............................................................................................................................#
#..###.........................................................................................................................#
#..######......................................................................................................................#
#..######......................................................................................................................#
#...####.......................................................................................................................#
#...##.........................................................................................................................#
#..............................................................................................................................#
#..............................................................................................................................#
#..............................................................................................................................#
#..............................................................................................................................#
#..............................................................................................................................#
#..............................................................................................................................#
#..............................................................................................................................#
################################################################################################################################
