################################################################################################################################
#.......................................................#.###..#.###...........................................................#
#....................................................................##........................................................#
#..###................................................#..............#.........................................................#
#..######........................#...#...................#.........#...........................................................#
#..######..............................#....#....................#.............................................................#
#...####.........................................#.............................................................................#
#...##...........#####.####.#####......##..#..##.#...............#.............................................................#
#....................#..#..#...#.##...#.....#.....##...#.##..#..#..#..#..#.....................................................#
#....................................#...#..#..#.#..#.#.#..#....#.......#....#.#.#.#...........................................#
#.................................#..................#.#....#......##..####.#..................................................#
#........................................#..........#............#.............................................................#
#..............................................#.#..................###........................................................#
#.............................................#.#...#....#.....#...............................................................#
#..............................................................................................................................#
################################################################################################################################
